...........................
...........................
.....#######...............
...........................
...........................
...........................
...........................
................#####......
...........................
...........................
.........#######...........
...........................
...........................
...........................
...........................
...........................
...........................
.........###########.......
...........................
...........................
...........................